1111111111111111111111111111111111
1C0000000000000C00010E100000000001
1P10010100100000101101000000010101
1110010010101010001101000000010101
100000000C00C0000000000000000000C1
1111111111111111111111111111111111